11111111111111111111111111111
1P0000110000011111C0000000001
11110011111100000111111111001
1C110000001000000011000000001
10111001111001111111111101001
10111001111001110000000001001
10000000011000000000110001001
10111111111111001111111111001
100010000000000011111C0000001
11000001001111111111111111011
11001001001010001111100001011
11111111111000000000000000011
10100111000011111111111111011
10100111000011000000000C11111
1010000000001100000000001C011
10111110011111110111111110011
11110000000000000000111110011
11010111111100111111110010011
10100001110000000000000000011
10100001010111111111110011011
10100000000000000100000000001
11101101011111111110111111111
1C000101011100010010111111101
10111101000000000000000000001
101C1101111111010011111111001
1010110101000101001C000001001
10101001010101010010000000001
10101001000101110011111111111
10001011011101111110000000001
100C10000111000000000000000E1
11111111111111111111111111111
