1111111111111111111
10C000000C00000C01
10000C0000000000001
100000000P0000C0001
100C00000C000000001
10000000000000000E1
1111111111111111111
