1111111111111111
1000000E00000001
1000000000000001
1000C000P0000001
1000000000000001
1000000000000001
111111111111111
