111111111111111111111
10C00000000E0000000C1
10000C00000000000C001
10000000000P000000001
10C0000000000000000C1
