111111111111111111
100000000000000001
100000000P00000001
100000C00000000001
100000000000000001
111111111111111111
