11111111111
10000P00001
11C00000C11
111C000C111
11110001111
11111C11111
11110001111
111C000C111
11C00000C11
1C000P000C1
11111111111
