11111111111111
p000000000000p
p000000000000p
p000000000000p
11111111111111
