11111111111111
100C0000000001
100P0000000001
100000000E0001
11111111111111
