111111111111111111
1P00011001100001C1
101001100110010101
101001100110010101
101001100110010101
101000000110010101
101011111110010001
100000000000011101
111111110000001101
100111100111001101
100111100101001101
100000000101001101
101111111101001101
101100011100000001
101100011111011111
1000000000000000E1
111111111111111111
