111111111111111111
1P00011C01100001C1
101001100110010101
101001100110010101
101001100110010101
101C00000110010101
101011111110010001
100000000C00011101
111111110000001101
100111100111001101
1001111001010C1101
100C00000101001101
101111111101001101
1011C001110C000001
101100011111011111
10C0000C00000000E1
111111111111111111
